system_traces`read_count	L	0
system_traces`read_latency	n	Latency:
system_traces`write_count	L	0
system_traces`write_latency	n	Latency:
system_traces`events`space_used_live	L	0
system_traces`events`space_used_total	L	0
system_traces`events`off_heap_mem_used	L	0
system_traces`events`sstable_compression_ratio	n	0.0
system_traces`events`num_keys_estimate	l	-1
system_traces`events`memtable_cell_count	L	0
system_traces`events`memtable_data_size	L	0
system_traces`events`memtable_off_heap_mem_used	L	0
system_traces`events`memtable_switch_count	L	0
system_traces`events`local_read_count	L	0
system_traces`events`local_read_latency	n	NaN
system_traces`events`local_write_count	L	0
system_traces`events`local_write_latency	n	NaN
system_traces`events`pending_flushes	L	0
system_traces`events`bloom_false_positives	L	0
system_traces`events`bloom_false_ratio	n	0.00000
system_traces`events`bloom_space_used	L	0
system_traces`events`bloom_off_heap_mem_used	L	0
system_traces`events`index_summary_off_heap_mem_used	L	0
system_traces`events`compression_metadata_off_heap_mem_used	L	0
system_traces`events`compacted_partition_min_bytes	L	0
system_traces`events`compacted_partition_max_bytes	L	0
system_traces`events`compacted_partition_mean_bytes	L	0
system_traces`events`avg_live_cells_per_slice	n	NaN
system_traces`events`max_live_cells_per_slice	L	0
system_traces`events`avg_live_cells_per_slice	n	NaN
system_traces`events`max_live_cells_per_slice	L	0
system_traces`sessions`space_used_live	L	0
system_traces`sessions`space_used_total	L	0
system_traces`sessions`off_heap_mem_used	L	0
system_traces`sessions`sstable_compression_ratio	n	0.0
system_traces`sessions`num_keys_estimate	l	-1
system_traces`sessions`memtable_cell_count	L	0
system_traces`sessions`memtable_data_size	L	0
system_traces`sessions`memtable_off_heap_mem_used	L	0
system_traces`sessions`memtable_switch_count	L	0
system_traces`sessions`local_read_count	L	0
system_traces`sessions`local_read_latency	n	NaN
system_traces`sessions`local_write_count	L	0
system_traces`sessions`local_write_latency	n	NaN
system_traces`sessions`pending_flushes	L	0
system_traces`sessions`bloom_false_positives	L	0
system_traces`sessions`bloom_false_ratio	n	0.00000
system_traces`sessions`bloom_space_used	L	0
system_traces`sessions`bloom_off_heap_mem_used	L	0
system_traces`sessions`index_summary_off_heap_mem_used	L	0
system_traces`sessions`compression_metadata_off_heap_mem_used	L	0
system_traces`sessions`compacted_partition_min_bytes	L	0
system_traces`sessions`compacted_partition_max_bytes	L	0
system_traces`sessions`compacted_partition_mean_bytes	L	0
system_traces`sessions`avg_live_cells_per_slice	n	NaN
system_traces`sessions`max_live_cells_per_slice	L	0
system_traces`sessions`avg_live_cells_per_slice	n	NaN
system_traces`sessions`max_live_cells_per_slice	L	0
system`read_count	L	828
system`read_latency	n	Latency:
system`write_count	L	7532
system`write_latency	n	Latency:
system`IndexInfo`space_used_live	L	0
system`IndexInfo`space_used_total	L	0
system`IndexInfo`off_heap_mem_used	L	0
system`IndexInfo`sstable_compression_ratio	n	0.0
system`IndexInfo`num_keys_estimate	l	-1
system`IndexInfo`memtable_cell_count	L	0
system`IndexInfo`memtable_data_size	L	0
system`IndexInfo`memtable_off_heap_mem_used	L	0
system`IndexInfo`memtable_switch_count	L	0
system`IndexInfo`local_read_count	L	0
system`IndexInfo`local_read_latency	n	NaN
system`IndexInfo`local_write_count	L	0
system`IndexInfo`local_write_latency	n	NaN
system`IndexInfo`pending_flushes	L	0
system`IndexInfo`bloom_false_positives	L	0
system`IndexInfo`bloom_false_ratio	n	0.00000
system`IndexInfo`bloom_space_used	L	0
system`IndexInfo`bloom_off_heap_mem_used	L	0
system`IndexInfo`index_summary_off_heap_mem_used	L	0
system`IndexInfo`compression_metadata_off_heap_mem_used	L	0
system`IndexInfo`compacted_partition_min_bytes	L	0
system`IndexInfo`compacted_partition_max_bytes	L	0
system`IndexInfo`compacted_partition_mean_bytes	L	0
system`IndexInfo`avg_live_cells_per_slice	n	NaN
system`IndexInfo`max_live_cells_per_slice	L	0
system`IndexInfo`avg_live_cells_per_slice	n	NaN
system`IndexInfo`max_live_cells_per_slice	L	0
system`available_ranges`space_used_live	L	0
system`available_ranges`space_used_total	L	0
system`available_ranges`off_heap_mem_used	L	0
system`available_ranges`sstable_compression_ratio	n	0.0
system`available_ranges`num_keys_estimate	l	-1
system`available_ranges`memtable_cell_count	L	0
system`available_ranges`memtable_data_size	L	0
system`available_ranges`memtable_off_heap_mem_used	L	0
system`available_ranges`memtable_switch_count	L	0
system`available_ranges`local_read_count	L	0
system`available_ranges`local_read_latency	n	NaN
system`available_ranges`local_write_count	L	0
system`available_ranges`local_write_latency	n	NaN
system`available_ranges`pending_flushes	L	0
system`available_ranges`bloom_false_positives	L	0
system`available_ranges`bloom_false_ratio	n	0.00000
system`available_ranges`bloom_space_used	L	0
system`available_ranges`bloom_off_heap_mem_used	L	0
system`available_ranges`index_summary_off_heap_mem_used	L	0
system`available_ranges`compression_metadata_off_heap_mem_used	L	0
system`available_ranges`compacted_partition_min_bytes	L	0
system`available_ranges`compacted_partition_max_bytes	L	0
system`available_ranges`compacted_partition_mean_bytes	L	0
system`available_ranges`avg_live_cells_per_slice	n	NaN
system`available_ranges`max_live_cells_per_slice	L	0
system`available_ranges`avg_live_cells_per_slice	n	NaN
system`available_ranges`max_live_cells_per_slice	L	0
system`batches`space_used_live	L	0
system`batches`space_used_total	L	0
system`batches`off_heap_mem_used	L	0
system`batches`sstable_compression_ratio	n	0.0
system`batches`num_keys_estimate	l	-1
system`batches`memtable_cell_count	L	0
system`batches`memtable_data_size	L	0
system`batches`memtable_off_heap_mem_used	L	0
system`batches`memtable_switch_count	L	0
system`batches`local_read_count	L	0
system`batches`local_read_latency	n	NaN
system`batches`local_write_count	L	0
system`batches`local_write_latency	n	NaN
system`batches`pending_flushes	L	0
system`batches`bloom_false_positives	L	0
system`batches`bloom_false_ratio	n	0.00000
system`batches`bloom_space_used	L	0
system`batches`bloom_off_heap_mem_used	L	0
system`batches`index_summary_off_heap_mem_used	L	0
system`batches`compression_metadata_off_heap_mem_used	L	0
system`batches`compacted_partition_min_bytes	L	0
system`batches`compacted_partition_max_bytes	L	0
system`batches`compacted_partition_mean_bytes	L	0
system`batches`avg_live_cells_per_slice	n	1.0
system`batches`max_live_cells_per_slice	L	1
system`batches`avg_live_cells_per_slice	n	1.0
system`batches`max_live_cells_per_slice	L	1
system`batchlog`space_used_live	L	0
system`batchlog`space_used_total	L	0
system`batchlog`off_heap_mem_used	L	0
system`batchlog`sstable_compression_ratio	n	0.0
system`batchlog`num_keys_estimate	l	-1
system`batchlog`memtable_cell_count	L	0
system`batchlog`memtable_data_size	L	0
system`batchlog`memtable_off_heap_mem_used	L	0
system`batchlog`memtable_switch_count	L	0
system`batchlog`local_read_count	L	0
system`batchlog`local_read_latency	n	NaN
system`batchlog`local_write_count	L	0
system`batchlog`local_write_latency	n	NaN
system`batchlog`pending_flushes	L	0
system`batchlog`bloom_false_positives	L	0
system`batchlog`bloom_false_ratio	n	0.00000
system`batchlog`bloom_space_used	L	0
system`batchlog`bloom_off_heap_mem_used	L	0
system`batchlog`index_summary_off_heap_mem_used	L	0
system`batchlog`compression_metadata_off_heap_mem_used	L	0
system`batchlog`compacted_partition_min_bytes	L	0
system`batchlog`compacted_partition_max_bytes	L	0
system`batchlog`compacted_partition_mean_bytes	L	0
system`batchlog`avg_live_cells_per_slice	n	NaN
system`batchlog`max_live_cells_per_slice	L	0
system`batchlog`avg_live_cells_per_slice	n	NaN
system`batchlog`max_live_cells_per_slice	L	0
system`built_views`space_used_live	L	0
system`built_views`space_used_total	L	0
system`built_views`off_heap_mem_used	L	0
system`built_views`sstable_compression_ratio	n	0.0
system`built_views`num_keys_estimate	l	-1
system`built_views`memtable_cell_count	L	0
system`built_views`memtable_data_size	L	0
system`built_views`memtable_off_heap_mem_used	L	0
system`built_views`memtable_switch_count	L	0
system`built_views`local_read_count	L	0
system`built_views`local_read_latency	n	NaN
system`built_views`local_write_count	L	0
system`built_views`local_write_latency	n	NaN
system`built_views`pending_flushes	L	0
system`built_views`bloom_false_positives	L	0
system`built_views`bloom_false_ratio	n	0.00000
system`built_views`bloom_space_used	L	0
system`built_views`bloom_off_heap_mem_used	L	0
system`built_views`index_summary_off_heap_mem_used	L	0
system`built_views`compression_metadata_off_heap_mem_used	L	0
system`built_views`compacted_partition_min_bytes	L	0
system`built_views`compacted_partition_max_bytes	L	0
system`built_views`compacted_partition_mean_bytes	L	0
system`built_views`avg_live_cells_per_slice	n	NaN
system`built_views`max_live_cells_per_slice	L	0
system`built_views`avg_live_cells_per_slice	n	NaN
system`built_views`max_live_cells_per_slice	L	0
system`compaction_history`space_used_live	L	14235
system`compaction_history`space_used_total	L	14235
system`compaction_history`off_heap_mem_used	L	152
system`compaction_history`sstable_compression_ratio	n	0.38227394807520143
system`compaction_history`num_keys_estimate	l	49
system`compaction_history`memtable_cell_count	L	2
system`compaction_history`memtable_data_size	L	432
system`compaction_history`memtable_off_heap_mem_used	L	0
system`compaction_history`memtable_switch_count	L	23
system`compaction_history`local_read_count	L	0
system`compaction_history`local_read_latency	n	NaN
system`compaction_history`local_write_count	L	49
system`compaction_history`local_write_latency	n	0.296
system`compaction_history`pending_flushes	L	0
system`compaction_history`bloom_false_positives	L	0
system`compaction_history`bloom_false_ratio	n	0.00000
system`compaction_history`bloom_space_used	L	88
system`compaction_history`bloom_off_heap_mem_used	L	72
system`compaction_history`index_summary_off_heap_mem_used	L	56
system`compaction_history`compression_metadata_off_heap_mem_used	L	24
system`compaction_history`compacted_partition_min_bytes	L	87
system`compaction_history`compacted_partition_max_bytes	L	149
system`compaction_history`compacted_partition_mean_bytes	L	136
system`compaction_history`avg_live_cells_per_slice	n	NaN
system`compaction_history`max_live_cells_per_slice	L	0
system`compaction_history`avg_live_cells_per_slice	n	NaN
system`compaction_history`max_live_cells_per_slice	L	0
system`hints`space_used_live	L	0
system`hints`space_used_total	L	0
system`hints`off_heap_mem_used	L	0
system`hints`sstable_compression_ratio	n	0.0
system`hints`num_keys_estimate	l	-1
system`hints`memtable_cell_count	L	0
system`hints`memtable_data_size	L	0
system`hints`memtable_off_heap_mem_used	L	0
system`hints`memtable_switch_count	L	0
system`hints`local_read_count	L	0
system`hints`local_read_latency	n	NaN
system`hints`local_write_count	L	0
system`hints`local_write_latency	n	NaN
system`hints`pending_flushes	L	0
system`hints`bloom_false_positives	L	0
system`hints`bloom_false_ratio	n	0.00000
system`hints`bloom_space_used	L	0
system`hints`bloom_off_heap_mem_used	L	0
system`hints`index_summary_off_heap_mem_used	L	0
system`hints`compression_metadata_off_heap_mem_used	L	0
system`hints`compacted_partition_min_bytes	L	0
system`hints`compacted_partition_max_bytes	L	0
system`hints`compacted_partition_mean_bytes	L	0
system`hints`avg_live_cells_per_slice	n	NaN
system`hints`max_live_cells_per_slice	L	0
system`hints`avg_live_cells_per_slice	n	NaN
system`hints`max_live_cells_per_slice	L	0
system`local`space_used_live	L	10932
system`local`space_used_total	L	10932
system`local`off_heap_mem_used	L	41
system`local`sstable_compression_ratio	n	0.8838990426457789
system`local`num_keys_estimate	l	1
system`local`memtable_cell_count	L	0
system`local`memtable_data_size	L	0
system`local`memtable_off_heap_mem_used	L	0
system`local`memtable_switch_count	L	4
system`local`local_read_count	L	824
system`local`local_read_latency	n	0.812
system`local`local_write_count	L	7
system`local`local_write_latency	n	0.880
system`local`pending_flushes	L	0
system`local`bloom_false_positives	L	0
system`local`bloom_false_ratio	n	0.00000
system`local`bloom_space_used	L	16
system`local`bloom_off_heap_mem_used	L	8
system`local`index_summary_off_heap_mem_used	L	17
system`local`compression_metadata_off_heap_mem_used	L	16
system`local`compacted_partition_min_bytes	L	5723
system`local`compacted_partition_max_bytes	L	6866
system`local`compacted_partition_mean_bytes	L	6866
system`local`avg_live_cells_per_slice	n	1.0
system`local`max_live_cells_per_slice	L	1
system`local`avg_live_cells_per_slice	n	1.0
system`local`max_live_cells_per_slice	L	1
system`paxos`space_used_live	L	0
system`paxos`space_used_total	L	0
system`paxos`off_heap_mem_used	L	0
system`paxos`sstable_compression_ratio	n	0.0
system`paxos`num_keys_estimate	l	-1
system`paxos`memtable_cell_count	L	0
system`paxos`memtable_data_size	L	0
system`paxos`memtable_off_heap_mem_used	L	0
system`paxos`memtable_switch_count	L	0
system`paxos`local_read_count	L	0
system`paxos`local_read_latency	n	NaN
system`paxos`local_write_count	L	0
system`paxos`local_write_latency	n	NaN
system`paxos`pending_flushes	L	0
system`paxos`bloom_false_positives	L	0
system`paxos`bloom_false_ratio	n	0.00000
system`paxos`bloom_space_used	L	0
system`paxos`bloom_off_heap_mem_used	L	0
system`paxos`index_summary_off_heap_mem_used	L	0
system`paxos`compression_metadata_off_heap_mem_used	L	0
system`paxos`compacted_partition_min_bytes	L	0
system`paxos`compacted_partition_max_bytes	L	0
system`paxos`compacted_partition_mean_bytes	L	0
system`paxos`avg_live_cells_per_slice	n	NaN
system`paxos`max_live_cells_per_slice	L	0
system`paxos`avg_live_cells_per_slice	n	NaN
system`paxos`max_live_cells_per_slice	L	0
system`peer_events`space_used_live	L	0
system`peer_events`space_used_total	L	0
system`peer_events`off_heap_mem_used	L	0
system`peer_events`sstable_compression_ratio	n	0.0
system`peer_events`num_keys_estimate	l	-1
system`peer_events`memtable_cell_count	L	0
system`peer_events`memtable_data_size	L	0
system`peer_events`memtable_off_heap_mem_used	L	0
system`peer_events`memtable_switch_count	L	0
system`peer_events`local_read_count	L	0
system`peer_events`local_read_latency	n	NaN
system`peer_events`local_write_count	L	0
system`peer_events`local_write_latency	n	NaN
system`peer_events`pending_flushes	L	0
system`peer_events`bloom_false_positives	L	0
system`peer_events`bloom_false_ratio	n	0.00000
system`peer_events`bloom_space_used	L	0
system`peer_events`bloom_off_heap_mem_used	L	0
system`peer_events`index_summary_off_heap_mem_used	L	0
system`peer_events`compression_metadata_off_heap_mem_used	L	0
system`peer_events`compacted_partition_min_bytes	L	0
system`peer_events`compacted_partition_max_bytes	L	0
system`peer_events`compacted_partition_mean_bytes	L	0
system`peer_events`avg_live_cells_per_slice	n	NaN
system`peer_events`max_live_cells_per_slice	L	0
system`peer_events`avg_live_cells_per_slice	n	NaN
system`peer_events`max_live_cells_per_slice	L	0
system`peers`space_used_live	L	10155
system`peers`space_used_total	L	10155
system`peers`off_heap_mem_used	L	32
system`peers`sstable_compression_ratio	n	0.8898259465279024
system`peers`num_keys_estimate	l	1
system`peers`memtable_cell_count	L	0
system`peers`memtable_data_size	L	0
system`peers`memtable_off_heap_mem_used	L	0
system`peers`memtable_switch_count	L	1
system`peers`local_read_count	L	3
system`peers`local_read_latency	n	0.197
system`peers`local_write_count	L	7
system`peers`local_write_latency	n	0.211
system`peers`pending_flushes	L	0
system`peers`bloom_false_positives	L	0
system`peers`bloom_false_ratio	n	0.00000
system`peers`bloom_space_used	L	16
system`peers`bloom_off_heap_mem_used	L	8
system`peers`index_summary_off_heap_mem_used	L	16
system`peers`compression_metadata_off_heap_mem_used	L	8
system`peers`compacted_partition_min_bytes	L	4769
system`peers`compacted_partition_max_bytes	L	5722
system`peers`compacted_partition_mean_bytes	L	5722
system`peers`avg_live_cells_per_slice	n	1.0
system`peers`max_live_cells_per_slice	L	1
system`peers`avg_live_cells_per_slice	n	1.0
system`peers`max_live_cells_per_slice	L	1
system`range_xfers`space_used_live	L	0
system`range_xfers`space_used_total	L	0
system`range_xfers`off_heap_mem_used	L	0
system`range_xfers`sstable_compression_ratio	n	0.0
system`range_xfers`num_keys_estimate	l	-1
system`range_xfers`memtable_cell_count	L	0
system`range_xfers`memtable_data_size	L	0
system`range_xfers`memtable_off_heap_mem_used	L	0
system`range_xfers`memtable_switch_count	L	0
system`range_xfers`local_read_count	L	0
system`range_xfers`local_read_latency	n	NaN
system`range_xfers`local_write_count	L	0
system`range_xfers`local_write_latency	n	NaN
system`range_xfers`pending_flushes	L	0
system`range_xfers`bloom_false_positives	L	0
system`range_xfers`bloom_false_ratio	n	0.00000
system`range_xfers`bloom_space_used	L	0
system`range_xfers`bloom_off_heap_mem_used	L	0
system`range_xfers`index_summary_off_heap_mem_used	L	0
system`range_xfers`compression_metadata_off_heap_mem_used	L	0
system`range_xfers`compacted_partition_min_bytes	L	0
system`range_xfers`compacted_partition_max_bytes	L	0
system`range_xfers`compacted_partition_mean_bytes	L	0
system`range_xfers`avg_live_cells_per_slice	n	NaN
system`range_xfers`max_live_cells_per_slice	L	0
system`range_xfers`avg_live_cells_per_slice	n	NaN
system`range_xfers`max_live_cells_per_slice	L	0
system`schema_aggregates`space_used_live	L	0
system`schema_aggregates`space_used_total	L	0
system`schema_aggregates`off_heap_mem_used	L	0
system`schema_aggregates`sstable_compression_ratio	n	0.0
system`schema_aggregates`num_keys_estimate	l	-1
system`schema_aggregates`memtable_cell_count	L	0
system`schema_aggregates`memtable_data_size	L	0
system`schema_aggregates`memtable_off_heap_mem_used	L	0
system`schema_aggregates`memtable_switch_count	L	0
system`schema_aggregates`local_read_count	L	0
system`schema_aggregates`local_read_latency	n	NaN
system`schema_aggregates`local_write_count	L	0
system`schema_aggregates`local_write_latency	n	NaN
system`schema_aggregates`pending_flushes	L	0
system`schema_aggregates`bloom_false_positives	L	0
system`schema_aggregates`bloom_false_ratio	n	0.00000
system`schema_aggregates`bloom_space_used	L	0
system`schema_aggregates`bloom_off_heap_mem_used	L	0
system`schema_aggregates`index_summary_off_heap_mem_used	L	0
system`schema_aggregates`compression_metadata_off_heap_mem_used	L	0
system`schema_aggregates`compacted_partition_min_bytes	L	0
system`schema_aggregates`compacted_partition_max_bytes	L	0
system`schema_aggregates`compacted_partition_mean_bytes	L	0
system`schema_aggregates`avg_live_cells_per_slice	n	NaN
system`schema_aggregates`max_live_cells_per_slice	L	0
system`schema_aggregates`avg_live_cells_per_slice	n	NaN
system`schema_aggregates`max_live_cells_per_slice	L	0
system`schema_columnfamilies`space_used_live	L	0
system`schema_columnfamilies`space_used_total	L	0
system`schema_columnfamilies`off_heap_mem_used	L	0
system`schema_columnfamilies`sstable_compression_ratio	n	0.0
system`schema_columnfamilies`num_keys_estimate	l	-1
system`schema_columnfamilies`memtable_cell_count	L	0
system`schema_columnfamilies`memtable_data_size	L	0
system`schema_columnfamilies`memtable_off_heap_mem_used	L	0
system`schema_columnfamilies`memtable_switch_count	L	0
system`schema_columnfamilies`local_read_count	L	0
system`schema_columnfamilies`local_read_latency	n	NaN
system`schema_columnfamilies`local_write_count	L	0
system`schema_columnfamilies`local_write_latency	n	NaN
system`schema_columnfamilies`pending_flushes	L	0
system`schema_columnfamilies`bloom_false_positives	L	0
system`schema_columnfamilies`bloom_false_ratio	n	0.00000
system`schema_columnfamilies`bloom_space_used	L	0
system`schema_columnfamilies`bloom_off_heap_mem_used	L	0
system`schema_columnfamilies`index_summary_off_heap_mem_used	L	0
system`schema_columnfamilies`compression_metadata_off_heap_mem_used	L	0
system`schema_columnfamilies`compacted_partition_min_bytes	L	0
system`schema_columnfamilies`compacted_partition_max_bytes	L	0
system`schema_columnfamilies`compacted_partition_mean_bytes	L	0
system`schema_columnfamilies`avg_live_cells_per_slice	n	NaN
system`schema_columnfamilies`max_live_cells_per_slice	L	0
system`schema_columnfamilies`avg_live_cells_per_slice	n	NaN
system`schema_columnfamilies`max_live_cells_per_slice	L	0
system`schema_columns`space_used_live	L	0
system`schema_columns`space_used_total	L	0
system`schema_columns`off_heap_mem_used	L	0
system`schema_columns`sstable_compression_ratio	n	0.0
system`schema_columns`num_keys_estimate	l	-1
system`schema_columns`memtable_cell_count	L	0
system`schema_columns`memtable_data_size	L	0
system`schema_columns`memtable_off_heap_mem_used	L	0
system`schema_columns`memtable_switch_count	L	0
system`schema_columns`local_read_count	L	0
system`schema_columns`local_read_latency	n	NaN
system`schema_columns`local_write_count	L	0
system`schema_columns`local_write_latency	n	NaN
system`schema_columns`pending_flushes	L	0
system`schema_columns`bloom_false_positives	L	0
system`schema_columns`bloom_false_ratio	n	0.00000
system`schema_columns`bloom_space_used	L	0
system`schema_columns`bloom_off_heap_mem_used	L	0
system`schema_columns`index_summary_off_heap_mem_used	L	0
system`schema_columns`compression_metadata_off_heap_mem_used	L	0
system`schema_columns`compacted_partition_min_bytes	L	0
system`schema_columns`compacted_partition_max_bytes	L	0
system`schema_columns`compacted_partition_mean_bytes	L	0
system`schema_columns`avg_live_cells_per_slice	n	NaN
system`schema_columns`max_live_cells_per_slice	L	0
system`schema_columns`avg_live_cells_per_slice	n	NaN
system`schema_columns`max_live_cells_per_slice	L	0
system`schema_functions`space_used_live	L	0
system`schema_functions`space_used_total	L	0
system`schema_functions`off_heap_mem_used	L	0
system`schema_functions`sstable_compression_ratio	n	0.0
system`schema_functions`num_keys_estimate	l	-1
system`schema_functions`memtable_cell_count	L	0
system`schema_functions`memtable_data_size	L	0
system`schema_functions`memtable_off_heap_mem_used	L	0
system`schema_functions`memtable_switch_count	L	0
system`schema_functions`local_read_count	L	0
system`schema_functions`local_read_latency	n	NaN
system`schema_functions`local_write_count	L	0
system`schema_functions`local_write_latency	n	NaN
system`schema_functions`pending_flushes	L	0
system`schema_functions`bloom_false_positives	L	0
system`schema_functions`bloom_false_ratio	n	0.00000
system`schema_functions`bloom_space_used	L	0
system`schema_functions`bloom_off_heap_mem_used	L	0
system`schema_functions`index_summary_off_heap_mem_used	L	0
system`schema_functions`compression_metadata_off_heap_mem_used	L	0
system`schema_functions`compacted_partition_min_bytes	L	0
system`schema_functions`compacted_partition_max_bytes	L	0
system`schema_functions`compacted_partition_mean_bytes	L	0
system`schema_functions`avg_live_cells_per_slice	n	NaN
system`schema_functions`max_live_cells_per_slice	L	0
system`schema_functions`avg_live_cells_per_slice	n	NaN
system`schema_functions`max_live_cells_per_slice	L	0
system`schema_keyspaces`space_used_live	L	0
system`schema_keyspaces`space_used_total	L	0
system`schema_keyspaces`off_heap_mem_used	L	0
system`schema_keyspaces`sstable_compression_ratio	n	0.0
system`schema_keyspaces`num_keys_estimate	l	-1
system`schema_keyspaces`memtable_cell_count	L	0
system`schema_keyspaces`memtable_data_size	L	0
system`schema_keyspaces`memtable_off_heap_mem_used	L	0
system`schema_keyspaces`memtable_switch_count	L	0
system`schema_keyspaces`local_read_count	L	0
system`schema_keyspaces`local_read_latency	n	NaN
system`schema_keyspaces`local_write_count	L	0
system`schema_keyspaces`local_write_latency	n	NaN
system`schema_keyspaces`pending_flushes	L	0
system`schema_keyspaces`bloom_false_positives	L	0
system`schema_keyspaces`bloom_false_ratio	n	0.00000
system`schema_keyspaces`bloom_space_used	L	0
system`schema_keyspaces`bloom_off_heap_mem_used	L	0
system`schema_keyspaces`index_summary_off_heap_mem_used	L	0
system`schema_keyspaces`compression_metadata_off_heap_mem_used	L	0
system`schema_keyspaces`compacted_partition_min_bytes	L	0
system`schema_keyspaces`compacted_partition_max_bytes	L	0
system`schema_keyspaces`compacted_partition_mean_bytes	L	0
system`schema_keyspaces`avg_live_cells_per_slice	n	1.0
system`schema_keyspaces`max_live_cells_per_slice	L	1
system`schema_keyspaces`avg_live_cells_per_slice	n	1.0
system`schema_keyspaces`max_live_cells_per_slice	L	1
system`schema_triggers`space_used_live	L	0
system`schema_triggers`space_used_total	L	0
system`schema_triggers`off_heap_mem_used	L	0
system`schema_triggers`sstable_compression_ratio	n	0.0
system`schema_triggers`num_keys_estimate	l	-1
system`schema_triggers`memtable_cell_count	L	0
system`schema_triggers`memtable_data_size	L	0
system`schema_triggers`memtable_off_heap_mem_used	L	0
system`schema_triggers`memtable_switch_count	L	0
system`schema_triggers`local_read_count	L	0
system`schema_triggers`local_read_latency	n	NaN
system`schema_triggers`local_write_count	L	0
system`schema_triggers`local_write_latency	n	NaN
system`schema_triggers`pending_flushes	L	0
system`schema_triggers`bloom_false_positives	L	0
system`schema_triggers`bloom_false_ratio	n	0.00000
system`schema_triggers`bloom_space_used	L	0
system`schema_triggers`bloom_off_heap_mem_used	L	0
system`schema_triggers`index_summary_off_heap_mem_used	L	0
system`schema_triggers`compression_metadata_off_heap_mem_used	L	0
system`schema_triggers`compacted_partition_min_bytes	L	0
system`schema_triggers`compacted_partition_max_bytes	L	0
system`schema_triggers`compacted_partition_mean_bytes	L	0
system`schema_triggers`avg_live_cells_per_slice	n	NaN
system`schema_triggers`max_live_cells_per_slice	L	0
system`schema_triggers`avg_live_cells_per_slice	n	NaN
system`schema_triggers`max_live_cells_per_slice	L	0
system`schema_usertypes`space_used_live	L	0
system`schema_usertypes`space_used_total	L	0
system`schema_usertypes`off_heap_mem_used	L	0
system`schema_usertypes`sstable_compression_ratio	n	0.0
system`schema_usertypes`num_keys_estimate	l	-1
system`schema_usertypes`memtable_cell_count	L	0
system`schema_usertypes`memtable_data_size	L	0
system`schema_usertypes`memtable_off_heap_mem_used	L	0
system`schema_usertypes`memtable_switch_count	L	0
system`schema_usertypes`local_read_count	L	0
system`schema_usertypes`local_read_latency	n	NaN
system`schema_usertypes`local_write_count	L	0
system`schema_usertypes`local_write_latency	n	NaN
system`schema_usertypes`pending_flushes	L	0
system`schema_usertypes`bloom_false_positives	L	0
system`schema_usertypes`bloom_false_ratio	n	0.00000
system`schema_usertypes`bloom_space_used	L	0
system`schema_usertypes`bloom_off_heap_mem_used	L	0
system`schema_usertypes`index_summary_off_heap_mem_used	L	0
system`schema_usertypes`compression_metadata_off_heap_mem_used	L	0
system`schema_usertypes`compacted_partition_min_bytes	L	0
system`schema_usertypes`compacted_partition_max_bytes	L	0
system`schema_usertypes`compacted_partition_mean_bytes	L	0
system`schema_usertypes`avg_live_cells_per_slice	n	NaN
system`schema_usertypes`max_live_cells_per_slice	L	0
system`schema_usertypes`avg_live_cells_per_slice	n	NaN
system`schema_usertypes`max_live_cells_per_slice	L	0
system`size_estimates`space_used_live	L	21053
system`size_estimates`space_used_total	L	21053
system`size_estimates`off_heap_mem_used	L	55
system`size_estimates`sstable_compression_ratio	n	0.198964915145653
system`size_estimates`num_keys_estimate	l	6
system`size_estimates`memtable_cell_count	L	968
system`size_estimates`memtable_data_size	L	116984
system`size_estimates`memtable_off_heap_mem_used	L	0
system`size_estimates`memtable_switch_count	L	67
system`size_estimates`local_read_count	L	0
system`size_estimates`local_read_latency	n	NaN
system`size_estimates`local_write_count	L	6440
system`size_estimates`local_write_latency	n	0.388
system`size_estimates`pending_flushes	L	0
system`size_estimates`bloom_false_positives	L	0
system`size_estimates`bloom_false_ratio	n	0.00000
system`size_estimates`bloom_space_used	L	16
system`size_estimates`bloom_off_heap_mem_used	L	8
system`size_estimates`index_summary_off_heap_mem_used	L	23
system`size_estimates`compression_metadata_off_heap_mem_used	L	24
system`size_estimates`compacted_partition_min_bytes	L	17085
system`size_estimates`compacted_partition_max_bytes	L	42510
system`size_estimates`compacted_partition_mean_bytes	L	29204
system`size_estimates`avg_live_cells_per_slice	n	NaN
system`size_estimates`max_live_cells_per_slice	L	0
system`size_estimates`avg_live_cells_per_slice	n	NaN
system`size_estimates`max_live_cells_per_slice	L	0
system`sstable_activity`space_used_live	L	5208
system`sstable_activity`space_used_total	L	5208
system`sstable_activity`off_heap_mem_used	L	73
system`sstable_activity`sstable_compression_ratio	n	1.1081081081081081
system`sstable_activity`num_keys_estimate	l	10
system`sstable_activity`memtable_cell_count	L	9
system`sstable_activity`memtable_data_size	L	149
system`sstable_activity`memtable_off_heap_mem_used	L	0
system`sstable_activity`memtable_switch_count	L	67
system`sstable_activity`local_read_count	L	1
system`sstable_activity`local_read_latency	n	0.219
system`sstable_activity`local_write_count	L	1029
system`sstable_activity`local_write_latency	n	0.107
system`sstable_activity`pending_flushes	L	0
system`sstable_activity`bloom_false_positives	L	0
system`sstable_activity`bloom_false_ratio	n	0.00000
system`sstable_activity`bloom_space_used	L	24
system`sstable_activity`bloom_off_heap_mem_used	L	16
system`sstable_activity`index_summary_off_heap_mem_used	L	41
system`sstable_activity`compression_metadata_off_heap_mem_used	L	16
system`sstable_activity`compacted_partition_min_bytes	L	73
system`sstable_activity`compacted_partition_max_bytes	L	86
system`sstable_activity`compacted_partition_mean_bytes	L	86
system`sstable_activity`avg_live_cells_per_slice	n	1.0
system`sstable_activity`max_live_cells_per_slice	L	1
system`sstable_activity`avg_live_cells_per_slice	n	1.0
system`sstable_activity`max_live_cells_per_slice	L	1
system`views_builds_in_progress`space_used_live	L	0
system`views_builds_in_progress`space_used_total	L	0
system`views_builds_in_progress`off_heap_mem_used	L	0
system`views_builds_in_progress`sstable_compression_ratio	n	0.0
system`views_builds_in_progress`num_keys_estimate	l	-1
system`views_builds_in_progress`memtable_cell_count	L	0
system`views_builds_in_progress`memtable_data_size	L	0
system`views_builds_in_progress`memtable_off_heap_mem_used	L	0
system`views_builds_in_progress`memtable_switch_count	L	0
system`views_builds_in_progress`local_read_count	L	0
system`views_builds_in_progress`local_read_latency	n	NaN
system`views_builds_in_progress`local_write_count	L	0
system`views_builds_in_progress`local_write_latency	n	NaN
system`views_builds_in_progress`pending_flushes	L	0
system`views_builds_in_progress`bloom_false_positives	L	0
system`views_builds_in_progress`bloom_false_ratio	n	0.00000
system`views_builds_in_progress`bloom_space_used	L	0
system`views_builds_in_progress`bloom_off_heap_mem_used	L	0
system`views_builds_in_progress`index_summary_off_heap_mem_used	L	0
system`views_builds_in_progress`compression_metadata_off_heap_mem_used	L	0
system`views_builds_in_progress`compacted_partition_min_bytes	L	0
system`views_builds_in_progress`compacted_partition_max_bytes	L	0
system`views_builds_in_progress`compacted_partition_mean_bytes	L	0
system`views_builds_in_progress`avg_live_cells_per_slice	n	NaN
system`views_builds_in_progress`max_live_cells_per_slice	L	0
system`views_builds_in_progress`avg_live_cells_per_slice	n	NaN
system`views_builds_in_progress`max_live_cells_per_slice	L	0
system_distributed`read_count	L	0
system_distributed`read_latency	n	Latency:
system_distributed`write_count	L	0
system_distributed`write_latency	n	Latency:
system_distributed`parent_repair_history`space_used_live	L	0
system_distributed`parent_repair_history`space_used_total	L	0
system_distributed`parent_repair_history`off_heap_mem_used	L	0
system_distributed`parent_repair_history`sstable_compression_ratio	n	0.0
system_distributed`parent_repair_history`num_keys_estimate	l	-1
system_distributed`parent_repair_history`memtable_cell_count	L	0
system_distributed`parent_repair_history`memtable_data_size	L	0
system_distributed`parent_repair_history`memtable_off_heap_mem_used	L	0
system_distributed`parent_repair_history`memtable_switch_count	L	0
system_distributed`parent_repair_history`local_read_count	L	0
system_distributed`parent_repair_history`local_read_latency	n	NaN
system_distributed`parent_repair_history`local_write_count	L	0
system_distributed`parent_repair_history`local_write_latency	n	NaN
system_distributed`parent_repair_history`pending_flushes	L	0
system_distributed`parent_repair_history`bloom_false_positives	L	0
system_distributed`parent_repair_history`bloom_false_ratio	n	0.00000
system_distributed`parent_repair_history`bloom_space_used	L	0
system_distributed`parent_repair_history`bloom_off_heap_mem_used	L	0
system_distributed`parent_repair_history`index_summary_off_heap_mem_used	L	0
system_distributed`parent_repair_history`compression_metadata_off_heap_mem_used	L	0
system_distributed`parent_repair_history`compacted_partition_min_bytes	L	0
system_distributed`parent_repair_history`compacted_partition_max_bytes	L	0
system_distributed`parent_repair_history`compacted_partition_mean_bytes	L	0
system_distributed`parent_repair_history`avg_live_cells_per_slice	n	NaN
system_distributed`parent_repair_history`max_live_cells_per_slice	L	0
system_distributed`parent_repair_history`avg_live_cells_per_slice	n	NaN
system_distributed`parent_repair_history`max_live_cells_per_slice	L	0
system_distributed`repair_history`space_used_live	L	0
system_distributed`repair_history`space_used_total	L	0
system_distributed`repair_history`off_heap_mem_used	L	0
system_distributed`repair_history`sstable_compression_ratio	n	0.0
system_distributed`repair_history`num_keys_estimate	l	-1
system_distributed`repair_history`memtable_cell_count	L	0
system_distributed`repair_history`memtable_data_size	L	0
system_distributed`repair_history`memtable_off_heap_mem_used	L	0
system_distributed`repair_history`memtable_switch_count	L	0
system_distributed`repair_history`local_read_count	L	0
system_distributed`repair_history`local_read_latency	n	NaN
system_distributed`repair_history`local_write_count	L	0
system_distributed`repair_history`local_write_latency	n	NaN
system_distributed`repair_history`pending_flushes	L	0
system_distributed`repair_history`bloom_false_positives	L	0
system_distributed`repair_history`bloom_false_ratio	n	0.00000
system_distributed`repair_history`bloom_space_used	L	0
system_distributed`repair_history`bloom_off_heap_mem_used	L	0
system_distributed`repair_history`index_summary_off_heap_mem_used	L	0
system_distributed`repair_history`compression_metadata_off_heap_mem_used	L	0
system_distributed`repair_history`compacted_partition_min_bytes	L	0
system_distributed`repair_history`compacted_partition_max_bytes	L	0
system_distributed`repair_history`compacted_partition_mean_bytes	L	0
system_distributed`repair_history`avg_live_cells_per_slice	n	NaN
system_distributed`repair_history`max_live_cells_per_slice	L	0
system_distributed`repair_history`avg_live_cells_per_slice	n	NaN
system_distributed`repair_history`max_live_cells_per_slice	L	0
system_schema`read_count	L	58
system_schema`read_latency	n	Latency:
system_schema`write_count	L	24
system_schema`write_latency	n	Latency:
system_schema`aggregates`space_used_live	L	10049
system_schema`aggregates`space_used_total	L	10049
system_schema`aggregates`off_heap_mem_used	L	82
system_schema`aggregates`sstable_compression_ratio	n	1.0408163265306123
system_schema`aggregates`num_keys_estimate	l	2
system_schema`aggregates`memtable_cell_count	L	0
system_schema`aggregates`memtable_data_size	L	0
system_schema`aggregates`memtable_off_heap_mem_used	L	0
system_schema`aggregates`memtable_switch_count	L	1
system_schema`aggregates`local_read_count	L	3
system_schema`aggregates`local_read_latency	n	0.069
system_schema`aggregates`local_write_count	L	2
system_schema`aggregates`local_write_latency	n	0.113
system_schema`aggregates`pending_flushes	L	0
system_schema`aggregates`bloom_false_positives	L	0
system_schema`aggregates`bloom_false_ratio	n	0.00000
system_schema`aggregates`bloom_space_used	L	32
system_schema`aggregates`bloom_off_heap_mem_used	L	16
system_schema`aggregates`index_summary_off_heap_mem_used	L	50
system_schema`aggregates`compression_metadata_off_heap_mem_used	L	16
system_schema`aggregates`compacted_partition_min_bytes	L	21
system_schema`aggregates`compacted_partition_max_bytes	L	29
system_schema`aggregates`compacted_partition_mean_bytes	L	27
system_schema`aggregates`avg_live_cells_per_slice	n	1.0
system_schema`aggregates`max_live_cells_per_slice	L	1
system_schema`aggregates`avg_live_cells_per_slice	n	1.0
system_schema`aggregates`max_live_cells_per_slice	L	1
system_schema`columns`space_used_live	L	10607
system_schema`columns`space_used_total	L	10607
system_schema`columns`off_heap_mem_used	L	55
system_schema`columns`sstable_compression_ratio	n	0.3208039834831188
system_schema`columns`num_keys_estimate	l	5
system_schema`columns`memtable_cell_count	L	0
system_schema`columns`memtable_data_size	L	0
system_schema`columns`memtable_off_heap_mem_used	L	0
system_schema`columns`memtable_switch_count	L	1
system_schema`columns`local_read_count	L	8
system_schema`columns`local_read_latency	n	0.954
system_schema`columns`local_write_count	L	4
system_schema`columns`local_write_latency	n	1.186
system_schema`columns`pending_flushes	L	0
system_schema`columns`bloom_false_positives	L	0
system_schema`columns`bloom_false_ratio	n	0.00000
system_schema`columns`bloom_space_used	L	24
system_schema`columns`bloom_off_heap_mem_used	L	16
system_schema`columns`index_summary_off_heap_mem_used	L	23
system_schema`columns`compression_metadata_off_heap_mem_used	L	16
system_schema`columns`compacted_partition_min_bytes	L	771
system_schema`columns`compacted_partition_max_bytes	L	6866
system_schema`columns`compacted_partition_mean_bytes	L	3500
system_schema`columns`avg_live_cells_per_slice	n	25.0
system_schema`columns`max_live_cells_per_slice	L	50
system_schema`columns`avg_live_cells_per_slice	n	1.0
system_schema`columns`max_live_cells_per_slice	L	1
system_schema`dropped_columns`space_used_live	L	0
system_schema`dropped_columns`space_used_total	L	0
system_schema`dropped_columns`off_heap_mem_used	L	0
system_schema`dropped_columns`sstable_compression_ratio	n	0.0
system_schema`dropped_columns`num_keys_estimate	l	-1
system_schema`dropped_columns`memtable_cell_count	L	0
system_schema`dropped_columns`memtable_data_size	L	0
system_schema`dropped_columns`memtable_off_heap_mem_used	L	0
system_schema`dropped_columns`memtable_switch_count	L	0
system_schema`dropped_columns`local_read_count	L	8
system_schema`dropped_columns`local_read_latency	n	0.088
system_schema`dropped_columns`local_write_count	L	0
system_schema`dropped_columns`local_write_latency	n	NaN
system_schema`dropped_columns`pending_flushes	L	0
system_schema`dropped_columns`bloom_false_positives	L	0
system_schema`dropped_columns`bloom_false_ratio	n	0.00000
system_schema`dropped_columns`bloom_space_used	L	0
system_schema`dropped_columns`bloom_off_heap_mem_used	L	0
system_schema`dropped_columns`index_summary_off_heap_mem_used	L	0
system_schema`dropped_columns`compression_metadata_off_heap_mem_used	L	0
system_schema`dropped_columns`compacted_partition_min_bytes	L	0
system_schema`dropped_columns`compacted_partition_max_bytes	L	0
system_schema`dropped_columns`compacted_partition_mean_bytes	L	0
system_schema`dropped_columns`avg_live_cells_per_slice	n	1.0
system_schema`dropped_columns`max_live_cells_per_slice	L	1
system_schema`dropped_columns`avg_live_cells_per_slice	n	1.0
system_schema`dropped_columns`max_live_cells_per_slice	L	1
system_schema`functions`space_used_live	L	10049
system_schema`functions`space_used_total	L	10049
system_schema`functions`off_heap_mem_used	L	82
system_schema`functions`sstable_compression_ratio	n	1.0408163265306123
system_schema`functions`num_keys_estimate	l	2
system_schema`functions`memtable_cell_count	L	0
system_schema`functions`memtable_data_size	L	0
system_schema`functions`memtable_off_heap_mem_used	L	0
system_schema`functions`memtable_switch_count	L	1
system_schema`functions`local_read_count	L	3
system_schema`functions`local_read_latency	n	0.085
system_schema`functions`local_write_count	L	2
system_schema`functions`local_write_latency	n	0.113
system_schema`functions`pending_flushes	L	0
system_schema`functions`bloom_false_positives	L	0
system_schema`functions`bloom_false_ratio	n	0.00000
system_schema`functions`bloom_space_used	L	32
system_schema`functions`bloom_off_heap_mem_used	L	16
system_schema`functions`index_summary_off_heap_mem_used	L	50
system_schema`functions`compression_metadata_off_heap_mem_used	L	16
system_schema`functions`compacted_partition_min_bytes	L	21
system_schema`functions`compacted_partition_max_bytes	L	29
system_schema`functions`compacted_partition_mean_bytes	L	27
system_schema`functions`avg_live_cells_per_slice	n	1.0
system_schema`functions`max_live_cells_per_slice	L	1
system_schema`functions`avg_live_cells_per_slice	n	1.0
system_schema`functions`max_live_cells_per_slice	L	1
system_schema`indexes`space_used_live	L	9877
system_schema`indexes`space_used_total	L	9877
system_schema`indexes`off_heap_mem_used	L	82
system_schema`indexes`sstable_compression_ratio	n	1.0408163265306123
system_schema`indexes`num_keys_estimate	l	2
system_schema`indexes`memtable_cell_count	L	0
system_schema`indexes`memtable_data_size	L	0
system_schema`indexes`memtable_off_heap_mem_used	L	0
system_schema`indexes`memtable_switch_count	L	1
system_schema`indexes`local_read_count	L	8
system_schema`indexes`local_read_latency	n	0.080
system_schema`indexes`local_write_count	L	2
system_schema`indexes`local_write_latency	n	0.113
system_schema`indexes`pending_flushes	L	0
system_schema`indexes`bloom_false_positives	L	0
system_schema`indexes`bloom_false_ratio	n	0.00000
system_schema`indexes`bloom_space_used	L	32
system_schema`indexes`bloom_off_heap_mem_used	L	16
system_schema`indexes`index_summary_off_heap_mem_used	L	50
system_schema`indexes`compression_metadata_off_heap_mem_used	L	16
system_schema`indexes`compacted_partition_min_bytes	L	21
system_schema`indexes`compacted_partition_max_bytes	L	29
system_schema`indexes`compacted_partition_mean_bytes	L	27
system_schema`indexes`avg_live_cells_per_slice	n	1.0
system_schema`indexes`max_live_cells_per_slice	L	1
system_schema`indexes`avg_live_cells_per_slice	n	1.0
system_schema`indexes`max_live_cells_per_slice	L	1
system_schema`keyspaces`space_used_live	L	5405
system_schema`keyspaces`space_used_total	L	5405
system_schema`keyspaces`off_heap_mem_used	L	55
system_schema`keyspaces`sstable_compression_ratio	n	0.4358523725834798
system_schema`keyspaces`num_keys_estimate	l	5
system_schema`keyspaces`memtable_cell_count	L	0
system_schema`keyspaces`memtable_data_size	L	0
system_schema`keyspaces`memtable_off_heap_mem_used	L	0
system_schema`keyspaces`memtable_switch_count	L	1
system_schema`keyspaces`local_read_count	L	3
system_schema`keyspaces`local_read_latency	n	0.747
system_schema`keyspaces`local_write_count	L	4
system_schema`keyspaces`local_write_latency	n	0.164
system_schema`keyspaces`pending_flushes	L	0
system_schema`keyspaces`bloom_false_positives	L	0
system_schema`keyspaces`bloom_false_ratio	n	0.00000
system_schema`keyspaces`bloom_space_used	L	24
system_schema`keyspaces`bloom_off_heap_mem_used	L	16
system_schema`keyspaces`index_summary_off_heap_mem_used	L	23
system_schema`keyspaces`compression_metadata_off_heap_mem_used	L	16
system_schema`keyspaces`compacted_partition_min_bytes	L	87
system_schema`keyspaces`compacted_partition_max_bytes	L	149
system_schema`keyspaces`compacted_partition_mean_bytes	L	121
system_schema`keyspaces`avg_live_cells_per_slice	n	3.0
system_schema`keyspaces`max_live_cells_per_slice	L	5
system_schema`keyspaces`avg_live_cells_per_slice	n	1.0
system_schema`keyspaces`max_live_cells_per_slice	L	1
system_schema`tables`space_used_live	L	9046
system_schema`tables`space_used_total	L	9046
system_schema`tables`off_heap_mem_used	L	55
system_schema`tables`sstable_compression_ratio	n	0.16901119912592188
system_schema`tables`num_keys_estimate	l	5
system_schema`tables`memtable_cell_count	L	0
system_schema`tables`memtable_data_size	L	0
system_schema`tables`memtable_off_heap_mem_used	L	0
system_schema`tables`memtable_switch_count	L	1
system_schema`tables`local_read_count	L	11
system_schema`tables`local_read_latency	n	0.598
system_schema`tables`local_write_count	L	4
system_schema`tables`local_write_latency	n	0.418
system_schema`tables`pending_flushes	L	0
system_schema`tables`bloom_false_positives	L	0
system_schema`tables`bloom_false_ratio	n	0.00000
system_schema`tables`bloom_space_used	L	24
system_schema`tables`bloom_off_heap_mem_used	L	16
system_schema`tables`index_summary_off_heap_mem_used	L	23
system_schema`tables`compression_metadata_off_heap_mem_used	L	16
system_schema`tables`compacted_partition_min_bytes	L	771
system_schema`tables`compacted_partition_max_bytes	L	6866
system_schema`tables`compacted_partition_mean_bytes	L	3080
system_schema`tables`avg_live_cells_per_slice	n	4.0
system_schema`tables`max_live_cells_per_slice	L	10
system_schema`tables`avg_live_cells_per_slice	n	1.0
system_schema`tables`max_live_cells_per_slice	L	1
system_schema`triggers`space_used_live	L	9877
system_schema`triggers`space_used_total	L	9877
system_schema`triggers`off_heap_mem_used	L	82
system_schema`triggers`sstable_compression_ratio	n	1.0408163265306123
system_schema`triggers`num_keys_estimate	l	2
system_schema`triggers`memtable_cell_count	L	0
system_schema`triggers`memtable_data_size	L	0
system_schema`triggers`memtable_off_heap_mem_used	L	0
system_schema`triggers`memtable_switch_count	L	1
system_schema`triggers`local_read_count	L	8
system_schema`triggers`local_read_latency	n	0.076
system_schema`triggers`local_write_count	L	2
system_schema`triggers`local_write_latency	n	0.234
system_schema`triggers`pending_flushes	L	0
system_schema`triggers`bloom_false_positives	L	0
system_schema`triggers`bloom_false_ratio	n	0.00000
system_schema`triggers`bloom_space_used	L	32
system_schema`triggers`bloom_off_heap_mem_used	L	16
system_schema`triggers`index_summary_off_heap_mem_used	L	50
system_schema`triggers`compression_metadata_off_heap_mem_used	L	16
system_schema`triggers`compacted_partition_min_bytes	L	21
system_schema`triggers`compacted_partition_max_bytes	L	29
system_schema`triggers`compacted_partition_mean_bytes	L	27
system_schema`triggers`avg_live_cells_per_slice	n	1.0
system_schema`triggers`max_live_cells_per_slice	L	1
system_schema`triggers`avg_live_cells_per_slice	n	1.0
system_schema`triggers`max_live_cells_per_slice	L	1
system_schema`types`space_used_live	L	9795
system_schema`types`space_used_total	L	9795
system_schema`types`off_heap_mem_used	L	82
system_schema`types`sstable_compression_ratio	n	1.0408163265306123
system_schema`types`num_keys_estimate	l	2
system_schema`types`memtable_cell_count	L	0
system_schema`types`memtable_data_size	L	0
system_schema`types`memtable_off_heap_mem_used	L	0
system_schema`types`memtable_switch_count	L	1
system_schema`types`local_read_count	L	3
system_schema`types`local_read_latency	n	0.455
system_schema`types`local_write_count	L	2
system_schema`types`local_write_latency	n	0.113
system_schema`types`pending_flushes	L	0
system_schema`types`bloom_false_positives	L	0
system_schema`types`bloom_false_ratio	n	0.00000
system_schema`types`bloom_space_used	L	32
system_schema`types`bloom_off_heap_mem_used	L	16
system_schema`types`index_summary_off_heap_mem_used	L	50
system_schema`types`compression_metadata_off_heap_mem_used	L	16
system_schema`types`compacted_partition_min_bytes	L	21
system_schema`types`compacted_partition_max_bytes	L	29
system_schema`types`compacted_partition_mean_bytes	L	27
system_schema`types`avg_live_cells_per_slice	n	1.0
system_schema`types`max_live_cells_per_slice	L	1
system_schema`types`avg_live_cells_per_slice	n	1.0
system_schema`types`max_live_cells_per_slice	L	1
system_schema`views`space_used_live	L	9795
system_schema`views`space_used_total	L	9795
system_schema`views`off_heap_mem_used	L	82
system_schema`views`sstable_compression_ratio	n	1.0408163265306123
system_schema`views`num_keys_estimate	l	2
system_schema`views`memtable_cell_count	L	0
system_schema`views`memtable_data_size	L	0
system_schema`views`memtable_off_heap_mem_used	L	0
system_schema`views`memtable_switch_count	L	1
system_schema`views`local_read_count	L	3
system_schema`views`local_read_latency	n	0.129
system_schema`views`local_write_count	L	2
system_schema`views`local_write_latency	n	0.202
system_schema`views`pending_flushes	L	0
system_schema`views`bloom_false_positives	L	0
system_schema`views`bloom_false_ratio	n	0.00000
system_schema`views`bloom_space_used	L	32
system_schema`views`bloom_off_heap_mem_used	L	16
system_schema`views`index_summary_off_heap_mem_used	L	50
system_schema`views`compression_metadata_off_heap_mem_used	L	16
system_schema`views`compacted_partition_min_bytes	L	21
system_schema`views`compacted_partition_max_bytes	L	29
system_schema`views`compacted_partition_mean_bytes	L	27
system_schema`views`avg_live_cells_per_slice	n	1.0
system_schema`views`max_live_cells_per_slice	L	1
system_schema`views`avg_live_cells_per_slice	n	1.0
system_schema`views`max_live_cells_per_slice	L	1
system_auth`read_count	L	2
system_auth`read_latency	n	Latency:
system_auth`write_count	L	1
system_auth`write_latency	n	Latency:
system_auth`resource_role_permissons_index`space_used_live	L	0
system_auth`resource_role_permissons_index`space_used_total	L	0
system_auth`resource_role_permissons_index`off_heap_mem_used	L	0
system_auth`resource_role_permissons_index`sstable_compression_ratio	n	0.0
system_auth`resource_role_permissons_index`num_keys_estimate	l	-1
system_auth`resource_role_permissons_index`memtable_cell_count	L	0
system_auth`resource_role_permissons_index`memtable_data_size	L	0
system_auth`resource_role_permissons_index`memtable_off_heap_mem_used	L	0
system_auth`resource_role_permissons_index`memtable_switch_count	L	0
system_auth`resource_role_permissons_index`local_read_count	L	0
system_auth`resource_role_permissons_index`local_read_latency	n	NaN
system_auth`resource_role_permissons_index`local_write_count	L	0
system_auth`resource_role_permissons_index`local_write_latency	n	NaN
system_auth`resource_role_permissons_index`pending_flushes	L	0
system_auth`resource_role_permissons_index`bloom_false_positives	L	0
system_auth`resource_role_permissons_index`bloom_false_ratio	n	0.00000
system_auth`resource_role_permissons_index`bloom_space_used	L	0
system_auth`resource_role_permissons_index`bloom_off_heap_mem_used	L	0
system_auth`resource_role_permissons_index`index_summary_off_heap_mem_used	L	0
system_auth`resource_role_permissons_index`compression_metadata_off_heap_mem_used	L	0
system_auth`resource_role_permissons_index`compacted_partition_min_bytes	L	0
system_auth`resource_role_permissons_index`compacted_partition_max_bytes	L	0
system_auth`resource_role_permissons_index`compacted_partition_mean_bytes	L	0
system_auth`resource_role_permissons_index`avg_live_cells_per_slice	n	NaN
system_auth`resource_role_permissons_index`max_live_cells_per_slice	L	0
system_auth`resource_role_permissons_index`avg_live_cells_per_slice	n	NaN
system_auth`resource_role_permissons_index`max_live_cells_per_slice	L	0
system_auth`role_members`space_used_live	L	0
system_auth`role_members`space_used_total	L	0
system_auth`role_members`off_heap_mem_used	L	0
system_auth`role_members`sstable_compression_ratio	n	0.0
system_auth`role_members`num_keys_estimate	l	-1
system_auth`role_members`memtable_cell_count	L	0
system_auth`role_members`memtable_data_size	L	0
system_auth`role_members`memtable_off_heap_mem_used	L	0
system_auth`role_members`memtable_switch_count	L	0
system_auth`role_members`local_read_count	L	0
system_auth`role_members`local_read_latency	n	NaN
system_auth`role_members`local_write_count	L	0
system_auth`role_members`local_write_latency	n	NaN
system_auth`role_members`pending_flushes	L	0
system_auth`role_members`bloom_false_positives	L	0
system_auth`role_members`bloom_false_ratio	n	0.00000
system_auth`role_members`bloom_space_used	L	0
system_auth`role_members`bloom_off_heap_mem_used	L	0
system_auth`role_members`index_summary_off_heap_mem_used	L	0
system_auth`role_members`compression_metadata_off_heap_mem_used	L	0
system_auth`role_members`compacted_partition_min_bytes	L	0
system_auth`role_members`compacted_partition_max_bytes	L	0
system_auth`role_members`compacted_partition_mean_bytes	L	0
system_auth`role_members`avg_live_cells_per_slice	n	NaN
system_auth`role_members`max_live_cells_per_slice	L	0
system_auth`role_members`avg_live_cells_per_slice	n	NaN
system_auth`role_members`max_live_cells_per_slice	L	0
system_auth`role_permissions`space_used_live	L	0
system_auth`role_permissions`space_used_total	L	0
system_auth`role_permissions`off_heap_mem_used	L	0
system_auth`role_permissions`sstable_compression_ratio	n	0.0
system_auth`role_permissions`num_keys_estimate	l	-1
system_auth`role_permissions`memtable_cell_count	L	0
system_auth`role_permissions`memtable_data_size	L	0
system_auth`role_permissions`memtable_off_heap_mem_used	L	0
system_auth`role_permissions`memtable_switch_count	L	0
system_auth`role_permissions`local_read_count	L	0
system_auth`role_permissions`local_read_latency	n	NaN
system_auth`role_permissions`local_write_count	L	0
system_auth`role_permissions`local_write_latency	n	NaN
system_auth`role_permissions`pending_flushes	L	0
system_auth`role_permissions`bloom_false_positives	L	0
system_auth`role_permissions`bloom_false_ratio	n	0.00000
system_auth`role_permissions`bloom_space_used	L	0
system_auth`role_permissions`bloom_off_heap_mem_used	L	0
system_auth`role_permissions`index_summary_off_heap_mem_used	L	0
system_auth`role_permissions`compression_metadata_off_heap_mem_used	L	0
system_auth`role_permissions`compacted_partition_min_bytes	L	0
system_auth`role_permissions`compacted_partition_max_bytes	L	0
system_auth`role_permissions`compacted_partition_mean_bytes	L	0
system_auth`role_permissions`avg_live_cells_per_slice	n	NaN
system_auth`role_permissions`max_live_cells_per_slice	L	0
system_auth`role_permissions`avg_live_cells_per_slice	n	NaN
system_auth`role_permissions`max_live_cells_per_slice	L	0
system_auth`roles`space_used_live	L	5138
system_auth`roles`space_used_total	L	5138
system_auth`roles`off_heap_mem_used	L	37
system_auth`roles`sstable_compression_ratio	n	1.0842105263157895
system_auth`roles`num_keys_estimate	l	1
system_auth`roles`memtable_cell_count	L	0
system_auth`roles`memtable_data_size	L	0
system_auth`roles`memtable_off_heap_mem_used	L	0
system_auth`roles`memtable_switch_count	L	1
system_auth`roles`local_read_count	L	2
system_auth`roles`local_read_latency	n	2.594
system_auth`roles`local_write_count	L	1
system_auth`roles`local_write_latency	n	0.379
system_auth`roles`pending_flushes	L	0
system_auth`roles`bloom_false_positives	L	0
system_auth`roles`bloom_false_ratio	n	0.00000
system_auth`roles`bloom_space_used	L	16
system_auth`roles`bloom_off_heap_mem_used	L	8
system_auth`roles`index_summary_off_heap_mem_used	L	21
system_auth`roles`compression_metadata_off_heap_mem_used	L	8
system_auth`roles`compacted_partition_min_bytes	L	87
system_auth`roles`compacted_partition_max_bytes	L	103
system_auth`roles`compacted_partition_mean_bytes	L	103
system_auth`roles`avg_live_cells_per_slice	n	1.0
system_auth`roles`max_live_cells_per_slice	L	1
system_auth`roles`avg_live_cells_per_slice	n	1.0
system_auth`roles`max_live_cells_per_slice	L	1
